






111111
10C001
1P0E01
111111