1111111111111
10010000S00C1
1000011111001
1P0011E0S00S1
1111111111111
