111111
100001
100001
10C001
1P0E01
111111